####################
#..................#
#....######........#
#..................#
#..................#
#..................#
#..................#
#..................#
#..................#
####################